00000000000000000000000000000000000000000
00000010000000010000000010110101001001010
00000100100000010100000110000001010000010
00001000010000000010000010100000010000100
00010000001000010000010000100001010001000
00101010100100000000100010000000010001000
01000000000010010000000000100001000000100
01000000000001010000000010101001010000010
00000000000000000000000000000000000000000